NO                 ./textures/walls/hitler.png
SO            ./textures/walls/nazi.png
EA                  ./textures/walls/wall.png
WE                ./textures/walls/eagle.png
F 200,10,211
C 15,99,11


1111111    1111111111111111111111
11100011111110000000000001
   111100000111000000001111111111
 1111000000000000000000001000000011
111111111011000001110000011111111
100000000011000001110111111111111
1111111111110101111110010001
1111111111111111111111111111
11111111111101011101010010001
110000001101010111000000100011111111111111111111
101000000000000001100000000000000000000000000001
101000000000000001100000000000000000000000000001
1010000000000000011000000000000000000000000000011111111
1010000000000000011N000000000000000000000000000000000001
1010000000000000011000000000000000000000000000011111111
101000000000000001100000000000000000000000000001
110000001101010111000000100011111111111111111111
101000000000000001100000000001
10000000000000000000010010001
110000011101111111110111100111
10000000110101011100000010001
100000000000000001100000000001
10000000000000000000010010001
110000011101111111110111100111
111111111111111111111111111111