NO                 ./path_to_the_north_texture
SO            ./path_to_the_south_texture
 WE                ./path_to_the_west_texture
EA                  ./path_to_the     _east_texture     

F 220,100,0 
C 3,30,211

1111
1N1 1
111 1