1111111111111111111111111
1000000000110000000000001
1011000001110000000000001
1001000000000000000000001
111111111011000001110000011111111
100000000011000001110111111111111
11110111111111011100000010001
11110111111111011101010010001
11000000110101011100000010001
10000000000000001100000010001
10000000000000001101010010001
11000001110101011111011110N0111
11110111011101011101111010001
1111111111111111111111111111

"10000000000000000000000000000001",
"10000000000000000000000000000001",
"10000000000000000000000000000001",
"10011111110000000000000000000001",
"10000000010000000000000000000001",
"10000000010000000000000000000001",
"10000000010000000000000000000001",
"10000000010000000000000000000001",
"11111111110000000000000000000001",
"10000000000000000000000000000001",
"10000000000000000000000000000001",
"10000000000000000N00000000000001",
"10000000000000000000000000000001",
"10000000000000000000000000000001",
"10000000000000000000000000000001",
"10000000000000000000000000000001",
"10000111110011111000000000000001",
"10000100000000001000000000000001",
"10000100000000001000000000000001",
"10000100000000001000000000000001",
"10000100000000001000000000000001",
"10000111110001111000000000000001",
"10000000010000000000000000000001",
"11110000010000011111100000000001",
"10010000010000010000100000000001",
"10010000010000010000100000000001",
"10010000011111110000100000000001",
"10010000000000000000100000000001",
"10010000000000000000100000000001",
"10011111111111111111100000000001",
"10000000000000000000000000000001",
"11111111111111111111111111111111"